RRRRRRRRRRRLRRRRRRRRRRRR
R___C____..B..........RR
RTTP___....L..........RR
R___R..RRRRLRRRRRRRRRRRR
R__TR...T..L.RT....RRRRR
R___R_C....B..G .......R
RT__RT.....B..  .......R
RS__R......L.RT....RRRRR
R___RR...RRLRRRRRRRRRRRR
R__________B__________RR
R_____T_S__L________T_CR
RRRRRRRRRRRLRRRRRRRRRRRR
