TTTTTTTTTTTTTTTTTTTTTTTT
T______________________T
T____C__________R______T
T______________________T
T_________T___TT__P____T
T________TTRERTTTTTT___T
T________TTTRTTTTTTCPP_T
TTPTTT____________R____T
TRCCTTT___CP__RR_______T
TCCCRTTT__P___CRR______T
TCR______TTT___P___STTTT
TTTTTTTTTTTTTTTTTTTTTTTT