TTTTTTTTTTTTTTTTTTTTTTTT
T____________P_________T
T________R_______R__S__T
T__C________R____P_____T
T____________C___R_____T
T_________T__________TTT
T_______RRRRRPPPRRRRRRTT
T_TTTTPTTT___T________TT
T_____________T___C___TT
TTTT_C______R____T____TT
TTT____________________T
TTTTTTTTTTTTTTTTTTTTTTTT