TTTTTTTTTTTTTTTTTTTTTTTT
T______________________T
T________CCCCCCC_______T
T______________________T
T_______________E_____MT
T______________________T
T______________________T
T______________________T
TTTTTTTTTTTTTTT   TTTTTT